+++++++++
+      ++
+ S    ++
+   ++ ++
+   + M++
+++++++++